2222222222222222-
0111111111111111-
0011100000000111-
1000001111110111-
1111111111110111-
1111111111000111-
1111111111011111-
1111000000011111-
1111011111111111-
1111011111111111-
0000011111111111-
2222222222222222