2222222222222222-
1111111111111111-
1011100000000111-
1011101111111111-
1011100000000011-
1011111111111011-
1011111111111011-
1011000000011011-
1000011111000011-
1111111111111111-
1111111111111111-
2222222222222222